0
#########
#.......#
#.......#
#P....###
#.......#
#.......#
#########