########
#...####
#...####
#...####
#....###
#.P...##
#......#
#......#
#......#
#......#
#......#
#......#
#......#
#......#
#......#
#......#
#......#
#......#
#......#
#......#
#......#
#......#
#......#
#......#
#......#
#......#
#......#
#......#
#......#
#......#
#......#
#......#
#......#
#......#
#......#
#......#
#......#
#......#
#......#
#......#
#......#
#......#
#......#
#......#
#......#
#......#
#......#
#......#
#......#
#......#
#......#
#......#
#......#
#......#
#......#
#......#
#......#
#......#
#......#
#......#
#......#
#......#
#......#
#......#
#......#
#......#
#......#
#......#
#......#
#......#
#......#
#......#
#......#
#......#
#......#
#......#
#......#
#......#
#......#
#......#
#......#
#......#
#......#
#......#
#......#
#......#
#......#
#......#
#......#
#......#
#......#
#......#
#......#
#......#
#......#
#......#
#......#
#......#
#......#
#......#
#......#
#......#
#......#
#......#
#......#
#......#
#......#
#......#
#......#
#......#
#......#
#......#
#......#
#......#
#......#
#......#
#......#
#......#
#......#
#......#
#......#
#......#
#......#
#......#
#......#
#......#
#......#
#......#
#......#
#......#
#......#
#......#
#......#
#......#
#......#
#......#
#......#
#......#
#......#
#......#
#......#
#......#
#......#
#......#
#......#
#......#
#......#
#......#
#......#
#......#
#......#
#......#
#......#
#......#
#......#
#......#
#......#
#......#
#......#
#......#
#......#
#......#
#......#
#......#
#......#
#......#
#......#
#......#
#......#
#......#
#......#
#......#
#......#
#......#
#......#
#......#
#......#
#......#
#......#
#......#
#......#
#......#
#......#
#......#
#......#
#......#
#......#
#......#
#......#
#......#
#......#
#......#
#......#
#......#
#......#
#......#
#......#
#......#
#......#
#......#
#......#
#......#
#......#
#......#
#......#
#......#
#......#
#......#
#......#
#......#
#......#
#......#
#......#
#......#
#......#
#......#
#......#
#......#
#......#
#......#
#......#
#......#
#......#
#......#
#......#
#......#
#......#
#......#
#......#
#......#
#......#
#......#
#......#
#......#
########